16
................
.#####.B######..
#.....##.....#..
.............#..
..##.........#..
..##...#######..
.............#..
A...............
#.....##.....#..
.............#..
..##.........#..
..##............
................
.............#..
..##.........#..
.............#..
